species,chrom,n_segregating,n_biallelic,n_multiallelic,n_fixed
arab,2L,4706274,4455134,251140,30512423
arab,2R,5895128,5578527,316601,38360553
arab,3L,3999294,3769016,230278,24401656
arab,3R,5395896,5062574,333322,31047934
arab,X,1143168,1103302,39866,11325534
colu,2L,19191810,13778238,5413572,16813321
colu,2R,22177386,16258069,5919317,22262373
colu,3L,15507379,10694054,4813325,13200477
colu,3R,20725697,14266078,6459619,16473705
colu,X,9760703,6582808,3177895,6602106
gamb,2L,14010783,11503069,2507714,21994348
gamb,2R,14914273,12692199,2222074,29525486
gamb,3L,10637179,8738902,1898277,18070677
gamb,3R,14560004,11885510,2674494,22639398
gamb,X,5350960,4526345,824615,11011849
gamb_colu,2L,23399073,14810300,8588773,12606058
gamb_colu,2R,27311972,17908354,9403618,17127787
gamb_colu,3L,18359977,11354182,7005795,10347879
gamb_colu,3R,24585296,15082007,9503289,12614106
gamb_colu,X,11122273,6745380,4376893,5240536
